Perhaps if you explore the laboratories of the Worthy Order of Curmudgeons you will discover more about their nefarious plans. Sunrise is set to be at 5:30 so you better be out by then or the Curmudgeons will catch you.

The Worthy Order of Curmudgeons
An Interactive Fiction by James Gain
Release 1 / Serial number 181024 / Inform 7 build 6M62 (I6/v6.33 lib 6/12N) SD

Shielded Corridor
Outside the Laboratories of the Worthy Order of Curmudgeons, the walls are shielded with sonic damping, fire proofing, acid-resistant lacquer, structural supports and storm baffling. (The last a recent addition inspired by Dr Crowther's experiments). The imposing entrance to the Prime Laboratory is in the south wall.

You can see the Cogway here.

4:20 am

>l cogway
The Affiliates of the Order are jealous of their secrets and this ornate double door constructed from massive cogs is one giant locking mechanism.

>open goway
You can't see any such thing.

>open cogway
It seems to be locked.

>unlock cogway
(with the Cogway)
(first taking the Cogway)
That's fixed in place.

* * *

>i
You are carrying nothing.

>x note
You can't see any such thing.

* * *

>l
Shielded Corridor
Outside the Laboratories of the Order of Curmudgeons, the walls are shielded with sonic damping, fire proofing, acid-resistant lacquer, structural supports and storm shielding. (The last a recent addition inspired by Dr Crowther's experiments).

The Affiliates of the Order are jealous of their secrets and this ornate double door constructed from massive cogs is one giant locking mechanism.

* * *

>e
You can't go that way.

>w
You can't go that way.

* * *

>s
(first opening the Cogway)

Prime Laboratory
This massive barrel-vaulted chamber is clustered with half a dozen ongoing experiments. Sparks surge between twisted prongs, sulphorous liquids bubble and murmur, and a half-made automaton rocks itself back and forth in the corner. The hair on the back of your neck rises. This could be from the terrible portent of the experiments conducted here over the centuries or it could be from the actinic charge in the air. 

 Crowther's Lab is to the west and the Insectarium is to the east. An archway leads south to the flight platform and is also useful for venting in an emergency.

You can see the Cogway, a Rail (on which is a Daedulus Flutter-wing (empty)), the Slow Glass, some Arcane Paraphernalia (in which are a spider-silk rope, perpetual machine, Tesla gun, rubber bullet and crystal shards), a Storm Globes and a carefully written note here.

4:21 am

>push flutter-wing
It is fixed in place.

>l glass
Slow and Glassy.

>l Paraphanalia
The detritus of half a hundred failed experiments. There might be something salvagable in here is your are prepared to risk rumaging.

* * *

>l Paraphernalia
The detritus of half a hundred failed experiments. There might be something salvagable in here if your are prepared to risk rumaging.

* * *

>l Paraphanalia
The detritus of half a hundred failed experiments. There might be something salvagable in here is your are prepared to risk rumaging.

>open Paraphanalia
That's not something you can open.

>look in Paraphanalia
You can't see inside, since the Arcane Paraphanalia is closed.

>open Praphanalia
You can't see any such thing.

>open Paraphanalia
That's not something you can open.

* * *

>l Rail
On the Rail is a Daedulus Flutter-wing.

* * *

>open Paraphanalia
You open the Arcane Paraphanalia, revealing a spider-silk rope, perpetual machine and Tesla gun.

* * *

>e
Clockwork Insectarium
This room is filled with twisted metal and stained glass constructs in a caricature of a jungle environment. Oversized clockwork beetles, worms, butterflies and spiders move slugishly among the syntetic foliage. A stained glass doorway leads west back to the main laboratory.

You can see the clockwork insects here.

4:22 am

>x instects
You can't see any such thing.

>x insects
Each insect is an order of magnitude larger than its biological counterpart, probably because Dr Turk is still having trouble with miniaturisation.

* * *

>e
Clockwork Insectarium
This room is filled with twisted metal and stained glass constructs in a caricature of a jungle environment. Oversized clockwork beetles, worms, butterflies and spiders move slugishly among the syntetic foliage. A stained glass doorway leads west back to the main laboratory.

You can see the clockwork insects here.

4:22 am

>s
You can't go that way.

4:23 am

>w
Prime Laboratory
This massive barrel-vaulted chamber is clustered with half a dozen ongoing experiments. Sparks surge between twisted prongs, sulphorous liquids bubble and murmur, and a half-made automaton rocks itself back and forth in the corner. The hair on the back of your neck rises. This could be from the terrible portent of the experiments conducted here over the centuries or it could be from the actinic charge in the air. 

 Crowther's Lab is to the west and the Insectarium is to the east. An archway leads south to the flight platform and is also useful for venting in an emergency.

You can see the Cogway, a Rail (on which is a Daedulus Flutter-wing (empty)), the Slow Glass, some Arcane Paraphernalia (in which are a spider-silk rope, perpetual machine, Tesla gun, rubber bullet and crystal shards), a Storm Globes and a carefully written note here.

4:24 am

>w
Crowther Lab
The walls of this spherical room are tiled in brass and streaked with soot from Dr Crowther's lightning experiments, but now it is dominated by the Crowther Engine.

You can see the Crowther Engine (closed) and a Brass Man here.

4:25 am

>s
Curmudgeons tactical room
On entering you see a large table surrounded by chairs. A map lays flat on it.

You can see a weapons table (in which is a bomb (on which is a timer)) here.

4:26 am

>switch on timer
10 minutes. Gotta get out of here.

4:27 am

>wait
Time passes.

4:28 am

>wait
Time passes.

4:29 am

>look at bomb
A large pipe bomb with a timer attached to it. The bomb looks impressively dangerous.

On the bomb is a timer.

4:30 am

>switch on timer
That's already on.

4:31 am

>switch timer on
That's already on.

4:32 am

>wait
Time passes.

4:33 am

>wait
Time passes.

4:34 am

>wait
Time passes.

4:35 am

>wait
Time passes.

4:36 am

>pray
That's not a verb I recognise.

4:36 am

>pwait
That's not a verb I recognise.

4:36 am

>wait
Time passes.

    *** The bomb explodes, destroying the Curmudgeons tower and their laboratories. Unfortunately you did not escape on time and died in the blast. ***

Would you like to RESTART, RESTORE a saved game, QUIT or UNDO the last command?

* * *

>w
Crowther Lab
You can see the Crowther Engine (in which is a Punch Card) and a Brass Man here.

>l card
A stiff white card with small regular holes that form the pattern "hole space space hole hole".

* * *

>s
Launch Platform
Up there you can feel the fresh breeze which contrasts with the damp acrid smell of the laboratories. In front of you is a large hot air balloon that looks ready for take off.

You can see a Tower Wall here.

4:22 am

>d
Tower Base
You can see a sheer wall here.

>u
Launch Platform
You can see a sheer wall here.

>u
Balloon Mooring

* * *

>s
Launch Platform
Up there you can feel the fresh breeze which contrasts with the damp acrid smell of the laboratories. In front of you is a large hot air balloon that looks ready for take off.

You can see a Tower Wall here.

4:22 am

>u
Balloon Mooring
You can see a Hot-Air Balloon (empty) here.

>d
Launch Platform
You can see a sheer wall here.

>d
Tower Base
You can see a sheer wall here.

* * *

>s
Launch Platform
Up there you can feel the fresh breeze which contrasts with the damp acrid smell of the laboratories. In front of you is a large hot air balloon that looks ready for take off.

You can see a Tower Wall here.

4:22 am

>l forest
A dense forest stretches towards the horizon. Nearby is the burnt out shell of a village. After Dr Corvine's invention of fire-rain the villagers decided to rebuild several miles away.

* * *

>s
Launch Platform
Up there you can feel the fresh breeze which contrasts with the damp acrid smell of the laboratories. In front of you is a large hot air balloon that looks ready for take off.

You can see a Tower Wall here.

4:22 am

>s
You can't go that way.

4:23 am

>down
(first opening the Tower Wall)
It seems to be locked.

4:24 am

>up
Balloon Mooring
You can see a Hot-Air Balloon (empty) here.

4:25 am

>look
Balloon Mooring
You can see a Hot-Air Balloon (empty) here.

4:26 am

>examine Hot-air balloon
The aircraft look like it could accomodate about 6 people. The controls look fairly simple and you are confident that you could use it if need be.

4:27 am

* * *

>s
You can't go that way.

4:23 am

>up
Balloon Mooring
You can see a Hot-Air Balloon (empty) here.

4:24 am

>get on Balloon
You get into the Hot-Air Balloon.

4:25 am

>down
Launch Platform (in the Hot-Air Balloon)
Up there you can feel the fresh breeze which contrasts with the damp acrid smell of the laboratories. In front of you is a large hot air balloon that looks ready for take off.

You can see a Tower Wall here.

4:26 am

>down
(first opening the Tower Wall)
It seems to be locked.

4:27 am

>w
*** The bomb explodes, destroying the Curmudgeons tower and their laboratories while you watch, flying away in the Hot-Air Balloon. Tobi might not have survived. ***

Would you like to RESTART, RESTORE a saved game, QUIT or UNDO the last command?

>w
Please give one of the answers above.

Would you like to RESTART, RESTORE a saved game, QUIT or UNDO the last command?

>w
Please give one of the answers above.

Would you like to RESTART, RESTORE a saved game, QUIT or UNDO the last command?

>e
Please give one of the answers above.

Would you like to RESTART, RESTORE a saved game, QUIT or UNDO the last command?

>w
Please give one of the answers above.

Would you like to RESTART, RESTORE a saved game, QUIT or UNDO the last command?

* * *

>s
Launch Platform
Up there you can feel the fresh breeze which contrasts with the damp acrid smell of the laboratories. In front of you is a large hot air balloon that looks ready for take off.

You can see a Tower Wall here.

4:22 am

>up
Balloon Mooring
You can see a Hot-Air Balloon (empty) here.

4:23 am

>w
Cannnot go there on foot. Maybe if I could fly...

4:24 am

>e
Tower Base
The base looks like a garage with your Donkey cart close to the opened doors that lead to the road.

You can see a Tower Wall and a Donkey Cart (empty) here.

4:25 am

>e
You can't go that way.

4:26 am

>w
town

4:27 am

>e
Tower Base
The base looks like a garage with your Donkey cart close to the opened doors that lead to the road.

You can see a Tower Wall and a Donkey Cart (empty) here.

4:28 am

>up
(first opening the Tower Wall)

Launch Platform
Up there you can feel the fresh breeze which contrasts with the damp acrid smell of the laboratories. In front of you is a large hot air balloon that looks ready for take off.

You can see a Tower Wall here.

4:29 am

>up
Balloon Mooring
You can see a Hot-Air Balloon (empty) here.

4:30 am

>get in balloon
You get into the Hot-Air Balloon.

4:31 am

>down
Launch Platform (in the Hot-Air Balloon)
Up there you can feel the fresh breeze which contrasts with the damp acrid smell of the laboratories. In front of you is a large hot air balloon that looks ready for take off.

You can see a Tower Wall here.

4:32 am

>up
Balloon Mooring (in the Hot-Air Balloon)

4:33 am

>w
*** The bomb explodes, destroying the Curmudgeons tower and their laboratories while you watch, flying away in the Hot-Air Balloon. Tobi might not have survived. ***

Would you like to RESTART, RESTORE a saved game, QUIT or UNDO the last command?

* * *

>w
Cannnot go there on foot. Maybe if I could fly...

4:24 am

>get in Balloon
You get into the Hot-Air Balloon.

4:25 am

>d
Cannot really go there in a Hot-Air Balloon.

4:26 am

>w
*** The bomb explodes, destroying the Curmudgeons tower and their laboratories while you watch, flying away in the Hot-Air Balloon. ***

Would you like to RESTART, RESTORE a saved game, QUIT or UNDO the last command?

* * *

>s
Launch Platform
Up there you can feel the fresh breeze which contrasts with the damp acrid smell of the laboratories. In front of you is a large hot air balloon that looks ready for take off.

You can see a Tower Wall here.

4:22 am

>n
Prime Laboratory
This massive barrel-vaulted chamber is clustered with half a dozen ongoing experiments. Sparks surge between twisted prongs, sulphorous liquids bubble and murmur, and a half-made automaton rocks itself back and forth in the corner. The hair on the back of your neck rises. This could be from the terrible portent of the experiments conducted here over the centuries or it could be from the actinic charge in the air. 

 Crowther's Lab is to the west and the Insectarium is to the east. An archway leads south to the flight platform and is also useful for venting in an emergency.

You can see the Cogway, a Rail (on which is a Daedulus Flutter-wing (empty)), the Slow Glass, some Arcane Paraphernalia (in which are a spider-silk rope, perpetual machine, Tesla gun, rubber bullet and crystal shards), a Storm Globes and a carefully written note here.

4:23 am

>take rubber bullet
Taken.

4:24 am

>e
Clockwork Insectarium
This room is filled with twisted metal and stained glass constructs in a caricature of a jungle environment. Oversized clockwork beetles, worms, butterflies and spiders move slugishly among the syntetic foliage. A stained glass doorway leads west back to the main laboratory.

You can see the clockwork insects here.

4:25 am

>n
Dr Crowther's study
This spacy room contains a sofa on the right side and a large bookshelf at the back. In front of you is Dr Crowther's desk.

You can see Dr Crowther's desk here.

4:26 am

>look at desk
A large desk filled withdrawings and scrappy notes. Crowther's life's work right here.

4:27 am

>open desk
It isn't something you can open.

4:28 am

>examine dest
You can't see any such thing.

4:28 am

>examine desk
A large desk filled withdrawings and scrappy notes. Crowther's life's work right here.

4:29 am

>open drawers
You open Dr Crowther's drawers, revealing an old pump air pistol.

4:30 am

>take pistol
Taken.

4:31 am

>put rubber bullet inside pistol
You put rubber bullet into the old pump air pistol.

4:32 am

>s
Clockwork Insectarium
This room is filled with twisted metal and stained glass constructs in a caricature of a jungle environment. Oversized clockwork beetles, worms, butterflies and spiders move slugishly among the syntetic foliage. A stained glass doorway leads west back to the main laboratory.

You can see the clockwork insects here.

4:33 am

>w
Prime Laboratory
This massive barrel-vaulted chamber is clustered with half a dozen ongoing experiments. Sparks surge between twisted prongs, sulphorous liquids bubble and murmur, and a half-made automaton rocks itself back and forth in the corner. The hair on the back of your neck rises. This could be from the terrible portent of the experiments conducted here over the centuries or it could be from the actinic charge in the air. 

 Crowther's Lab is to the west and the Insectarium is to the east. An archway leads south to the flight platform and is also useful for venting in an emergency.

You can see the Cogway, a Rail (on which is a Daedulus Flutter-wing (empty)), the Slow Glass, some Arcane Paraphernalia (in which are a spider-silk rope, perpetual machine, Tesla gun and crystal shards), a Storm Globes and a carefully written note here.

4:34 am

>w
Crowther Lab
The walls of this spherical room are tiled in brass and streaked with soot from Dr Crowther's lightning experiments, but now it is dominated by the Crowther Engine.

You can see a metal door, the Crowther Engine (closed), a Brass Man and a doors panel (on which is a key) here.

4:35 am

>shoot
What do you want to shoot?

4:35 am

>shoot the old pump air pistol
What do you want to shoot the old pump air pistol with?

4:35 am

>shoot the old pump air pistol with the rubber bullet
"Tak!" The key falls and you grab it
4:36 am

>inventory
You are carrying:
  a key
  an old pump air pistol
    rubber bullet
  an explanatory note

4:37 am

>e
Prime Laboratory
This massive barrel-vaulted chamber is clustered with half a dozen ongoing experiments. Sparks surge between twisted prongs, sulphorous liquids bubble and murmur, and a half-made automaton rocks itself back and forth in the corner. The hair on the back of your neck rises. This could be from the terrible portent of the experiments conducted here over the centuries or it could be from the actinic charge in the air. 

 Crowther's Lab is to the west and the Insectarium is to the east. An archway leads south to the flight platform and is also useful for venting in an emergency.

You can see the Cogway, a Rail (on which is a Daedulus Flutter-wing (empty)), the Slow Glass, some Arcane Paraphernalia (in which are a spider-silk rope, perpetual machine, Tesla gun and crystal shards), a Storm Globes and a carefully written note here.

4:38 am

>s
Launch Platform
Up there you can feel the fresh breeze which contrasts with the damp acrid smell of the laboratories. In front of you is a large hot air balloon that looks ready for take off.

You can see a Tower Wall here.

4:39 am

>n
Prime Laboratory
This massive barrel-vaulted chamber is clustered with half a dozen ongoing experiments. Sparks surge between twisted prongs, sulphorous liquids bubble and murmur, and a half-made automaton rocks itself back and forth in the corner. The hair on the back of your neck rises. This could be from the terrible portent of the experiments conducted here over the centuries or it could be from the actinic charge in the air. 

 Crowther's Lab is to the west and the Insectarium is to the east. An archway leads south to the flight platform and is also useful for venting in an emergency.

You can see the Cogway, a Rail (on which is a Daedulus Flutter-wing (empty)), the Slow Glass, some Arcane Paraphernalia (in which are a spider-silk rope, perpetual machine, Tesla gun and crystal shards), a Storm Globes and a carefully written note here.

4:40 am

>s
Launch Platform
Up there you can feel the fresh breeze which contrasts with the damp acrid smell of the laboratories. In front of you is a large hot air balloon that looks ready for take off.

You can see a Tower Wall here.

4:41 am

>s
You can't go that way.

4:42 am

>n
Prime Laboratory
This massive barrel-vaulted chamber is clustered with half a dozen ongoing experiments. Sparks surge between twisted prongs, sulphorous liquids bubble and murmur, and a half-made automaton rocks itself back and forth in the corner. The hair on the back of your neck rises. This could be from the terrible portent of the experiments conducted here over the centuries or it could be from the actinic charge in the air. 

 Crowther's Lab is to the west and the Insectarium is to the east. An archway leads south to the flight platform and is also useful for venting in an emergency.

You can see the Cogway, a Rail (on which is a Daedulus Flutter-wing (empty)), the Slow Glass, some Arcane Paraphernalia (in which are a spider-silk rope, perpetual machine, Tesla gun and crystal shards), a Storm Globes and a carefully written note here.

4:43 am

>w
Crowther Lab
The walls of this spherical room are tiled in brass and streaked with soot from Dr Crowther's lightning experiments, but now it is dominated by the Crowther Engine.

You can see a metal door, the Crowther Engine (closed), a Brass Man and a doors panel here.

4:44 am

>s
(first opening the metal door)
It seems to be locked.

4:45 am

>look
Crowther Lab
The walls of this spherical room are tiled in brass and streaked with soot from Dr Crowther's lightning experiments, but now it is dominated by the Crowther Engine.

You can see a metal door, the Crowther Engine (closed), a Brass Man and a doors panel here.

4:46 am

>examine metal door
An imposing door that piques your interest. The door has a strangely shaped lock.

4:47 am

>open metal door with key
You unlock the metal door.

4:48 am

>s
(first opening the metal door)

Curmudgeons tactical room
On entering you see a large table surrounded by chairs. A map lays flat on it. To your right is a weapons table.

You can see a metal door, a weapons table (in which is a bomb (on which is a timer)) and a command table (on which is a map) here.

4:49 am

>look at command table
On the command table is a map.

4:50 am

>examine command table
On the command table is a map.

4:51 am

>look at map
A map depicting the nearby town, Mekley with an "X" marked on the town. The picture of a bomb is also drawn on the town. Could those fiendish Curmudgeons be planning to bomb Mekley?! I have to stop this.

4:52 am

>look at bomb
A large pipe bomb with a timer attached to it. The bomb looks impressively dangerous.

On the bomb is a timer.

4:53 am

>switch on timer
15 minutes. Gotta get out of here.

4:54 am

>e
You can't go that way.

4:55 am

>s
You can't go that way.

4:56 am

>n
Crowther Lab
The walls of this spherical room are tiled in brass and streaked with soot from Dr Crowther's lightning experiments, but now it is dominated by the Crowther Engine.

You can see a metal door, the Crowther Engine (closed), a Brass Man and a doors panel here.

4:57 am

>e
Prime Laboratory
This massive barrel-vaulted chamber is clustered with half a dozen ongoing experiments. Sparks surge between twisted prongs, sulphorous liquids bubble and murmur, and a half-made automaton rocks itself back and forth in the corner. The hair on the back of your neck rises. This could be from the terrible portent of the experiments conducted here over the centuries or it could be from the actinic charge in the air. 

 Crowther's Lab is to the west and the Insectarium is to the east. An archway leads south to the flight platform and is also useful for venting in an emergency.

You can see the Cogway, a Rail (on which is a Daedulus Flutter-wing (empty)), the Slow Glass, some Arcane Paraphernalia (in which are a spider-silk rope, perpetual machine, Tesla gun and crystal shards), a Storm Globes and a carefully written note here.

4:58 am

>s
Launch Platform
Up there you can feel the fresh breeze which contrasts with the damp acrid smell of the laboratories. In front of you is a large hot air balloon that looks ready for take off.

You can see a Tower Wall here.

4:59 am

>up
Balloon Mooring
You can see a Hot-Air Balloon (empty) here.

5:00 am

>get in the Balloon
You get into the Hot-Air Balloon.

5:01 am

>west
*** The bomb explodes, destroying the Curmudgeons tower and their laboratories while you watch, flying away in the Hot-Air Balloon. You Win. ***

Would you like to RESTART, RESTORE a saved game, QUIT or UNDO the last command?

* * *

>x glass
You are shocked to see Dr Crowther reflected in the glass but then you realize that it is only light from earlier this afternoon leaking through slowly.

* * *

>look at rai;
You can't see any such thing.

>look at rail
A rail and pulley system that runs across the ceiling so that Dr Peabody's infernal flying machines can be carried to the Launch Platform.

On the Rail is a Daedulus Flutter-wing (empty).

>look at flutter-wing
Peabody's pride and joy but you would have to be suicidal to try and fly in it.

>get in flutter wing
You can't see any such thing.

>look at slow glass
You are shocked to see Dr Crowther on the other side of the glass, but then you realize that it is only light from earlier this afternoon slowly leaking through.

>s
Launch Platform
You can see a Tower Wall here.

>n
Prime Laboratory
This massive barrel-vaulted chamber is clustered with half a dozen ongoing experiments. Sparks surge between twisted prongs, sulphorous liquids bubble and murmur, and a half-made automaton rocks itself back and forth in the corner. The hair on the back of your neck rises. This could be from the terrible portent of the experiments conducted here over the centuries or it could be from the actinic charge in the air. 

 Crowther's Lab is to the west and the Insectarium is to the east. An archway leads south to the flight platform and is also useful for venting in an emergency.

You can see the Cogway, a Rail (on which is a Daedulus Flutter-wing (empty)), the Slow Glass, some Arcane Paraphernalia (closed) and a Storm Globes here.

>e
Clockwork Insectarium
This room is filled with twisted metal and stained glass constructs in a caricature of a jungle environment. Oversized clockwork beetles, worms, butterflies and spiders move slugishly among the syntetic foliage. A stained glass doorway leads west back to the main laboratory.

You can see the clockwork insects here.

>w
Prime Laboratory
This massive barrel-vaulted chamber is clustered with half a dozen ongoing experiments. Sparks surge between twisted prongs, sulphorous liquids bubble and murmur, and a half-made automaton rocks itself back and forth in the corner. The hair on the back of your neck rises. This could be from the terrible portent of the experiments conducted here over the centuries or it could be from the actinic charge in the air. 

 Crowther's Lab is to the west and the Insectarium is to the east. An archway leads south to the flight platform and is also useful for venting in an emergency.

You can see the Cogway, a Rail (on which is a Daedulus Flutter-wing (empty)), the Slow Glass, some Arcane Paraphernalia (closed) and a Storm Globes here.

>w
Crowther Lab
The walls of this spherical room are tiled in brass and streaked with soot from Dr Crowther's lightning experiments, but now it is dominated by the Crowther Engine.

You can see the Crowther Engine (closed) and a Brass Man here.

* * *

>examine note
(the explanatory note)
This hastily penned note reads "I'm sure she is somewhere in the laboratories".

>examine carefully written note
A note written with care reads "I know you wanted it. You'll find it in the congelator , C"

* * *

>examine carefully written note
A note written with care reads "I know you wanted it. You'll find it in the congelator, C"

>w
Crowther Lab
The walls of this spherical room are tiled in brass and streaked with soot from Dr Crowther's lightning experiments, but now it is dominated by the Crowther Engine.

You can see the Crowther Engine (closed) and a Brass Man here.

>n
Morgue
 This room has a noticeably lower temperature. The walls have been fitted with drawers presumably contaning corpses waiting to be experimented on by Dr Crowther. A large metal table containing various tools is positioned in the middle of the room.  A large metallic cabinet is at the back of the room, a label on it says "Congelator".

You can see a Congelator (empty) here.

* * *

>Read carefully written note
A note written with care reads "I know you wanted it. It's innapropriate but you'll find it in the congelator, C".

4:22 am

>w
Crowther Lab
The walls of this spherical room are tiled in brass and streaked with soot from Dr Crowther's lightning experiments, but now it is dominated by the Crowther Engine.

You can see the Crowther Engine (closed) and a Brass Man here.

4:23 am

>n
Morgue
 This room has a noticeably lower temperature. The walls have been fitted with drawers presumably contaning corpses waiting to be experimented on by Dr Crowther. A large metal table containing various tools is positioned in the middle of the room.  A large metallic cabinet is at the back of the room, a label on it says "Congelator".

You can see a Congelator (closed) here.

4:24 am

>open Congelator
You open the Congelator, revealing an appetizing chocolate cupcake.

4:25 am

>take cupcake
Taken.

4:26 am

>eat cupcake
"gulp" Nice.

4:27 am

>look
Morgue
 This room has a noticeably lower temperature. The walls have been fitted with drawers presumably contaning corpses waiting to be experimented on by Dr Crowther. A large metal table containing various tools is positioned in the middle of the room.  A large metallic cabinet is at the back of the room, a label on it says "Congelator".

You can see a Congelator (empty) here.

4:28 am

>examine congelator
Dr Crowther's first invention. Using the pressure of steam power, Dr Crowther had managed to drop the temperature inside this cabinet to 5 degrees celcius.

4:29 am

>wait
Time passes.

4:30 am

>wait
Time passes.

4:31 am

>wait
Time passes.

4:32 am

>wait
Time passes.

4:33 am

* * *

>wait
Time passes.

4:35 am

>s
Crowther Lab
The walls of this spherical room are tiled in brass and streaked with soot from Dr Crowther's lightning experiments, but now it is dominated by the Crowther Engine.

You can see the Crowther Engine (closed) and a Brass Man here.

4:36 am

>e
Prime Laboratory
This massive barrel-vaulted chamber is clustered with half a dozen ongoing experiments. Sparks surge between twisted prongs, sulphorous liquids bubble and murmur, and a half-made automaton rocks itself back and forth in the corner. The hair on the back of your neck rises. This could be from the terrible portent of the experiments conducted here over the centuries or it could be from the actinic charge in the air. 

 Crowther's Lab is to the west and the Insectarium is to the east. An archway leads south to the flight platform and is also useful for venting in an emergency.

You can see the Cogway, a Rail (on which is a Daedulus Flutter-wing (empty)), the Slow Glass, some Arcane Paraphernalia (in which are a spider-silk rope, perpetual machine, Tesla gun, rubber bullet and crystal shards), a Storm Globes and a carefully written note here.

4:37 am

>look
Prime Laboratory
This massive barrel-vaulted chamber is clustered with half a dozen ongoing experiments. Sparks surge between twisted prongs, sulphorous liquids bubble and murmur, and a half-made automaton rocks itself back and forth in the corner. The hair on the back of your neck rises. This could be from the terrible portent of the experiments conducted here over the centuries or it could be from the actinic charge in the air. 

 Crowther's Lab is to the west and the Insectarium is to the east. An archway leads south to the flight platform and is also useful for venting in an emergency.

You can see the Cogway, a Rail (on which is a Daedulus Flutter-wing (empty)), the Slow Glass, some Arcane Paraphernalia (in which are a spider-silk rope, perpetual machine, Tesla gun, rubber bullet and crystal shards), a Storm Globes and a carefully written note here.

4:38 am

>look at arcane paraphernalia
The detritus of half a hundred failed experiments. There might be something salvagable in here if your are prepared to risk rumagging.

In the Arcane Paraphernalia are a spider-silk rope, perpetual machine, Tesla gun, rubber bullet and crystal shards.

4:39 am

>take arcane paraphernalia
Taken.

4:40 am

>inventory
You are carrying:
  some Arcane Paraphernalia (open)
    a spider-silk rope
    perpetual machine
    Tesla gun
    rubber bullet
    crystal shards
  an explanatory note

4:41 am

>examine perpetual machine
You see nothing special about perpetual machine.

4:42 am

>s
Launch Platform
You can see a Tower Wall here.

4:43 am

>up
Balloon Mooring
You can see a Hot-Air Balloon (empty) here.

4:44 am

>get in balloon
You get into the Hot-Air Balloon.

4:45 am

>fly
That's not a verb I recognise.

4:45 am

>fly away
That's not a verb I recognise.

4:45 am

>e
You can't go that way.

4:46 am

>s
You can't go that way.

4:47 am

>down
Launch Platform (in the Hot-Air Balloon)
You can see a Tower Wall here.

4:48 am

>up
Balloon Mooring (in the Hot-Air Balloon)

4:49 am

>up
You can't go that way.

4:50 am

* * *

>look at rail
A rail and pulley system that runs across the ceiling so that Dr Peabody's infernal flying machines can be carried to the Launch Platform.

On the Rail is a Daedulus Flutter-wing (empty).

4:22 am

>enter the Daedulus Flutter-wing
(getting onto the Rail)
That's not something you can enter.

4:23 am

>get on the rail
That's not something you can enter.

4:24 am

>s
Launch Platform
Up there you can feel the fresh breeze which contrasts with the damp acrid smell of the laboratories. In front of you is a large hot air balloon that looks ready for take off.

You can see a Tower Wall here.

4:25 am

>up
Balloon Mooring
You can see a Hot-Air Balloon (empty) here.

4:26 am

>get on Balloon
You get into the Hot-Air Balloon.

4:27 am

>down
Launch Platform (in the Hot-Air Balloon)
Up there you can feel the fresh breeze which contrasts with the damp acrid smell of the laboratories. In front of you is a large hot air balloon that looks ready for take off.

You can see a Tower Wall here.

4:28 am

>down
(first opening the Tower Wall)
It seems to be locked.

4:29 am

* * *

>look at rubber bullet
A sturdy rubber bullet with slight dints. It looks like it could fit in some weapon.

4:22 am

>s
Launch Platform
Up there you can feel the fresh breeze which contrasts with the damp acrid smell of the laboratories. In front of you is a large hot air balloon that looks ready for take off.

You can see a Tower Wall here.

4:23 am

>n
Prime Laboratory
This massive barrel-vaulted chamber is clustered with half a dozen ongoing experiments. Sparks surge between twisted prongs, sulphorous liquids bubble and murmur, and a half-made automaton rocks itself back and forth in the corner. The hair on the back of your neck rises. This could be from the terrible portent of the experiments conducted here over the centuries or it could be from the actinic charge in the air. 

 Crowther's Lab is to the west and the Insectarium is to the east. An archway leads south to the flight platform and is also useful for venting in an emergency.

You can see the Cogway, a Rail (on which is a Daedulus Flutter-wing (empty)), the Slow Glass, some Arcane Paraphernalia (in which are a spider-silk rope, perpetual machine, Tesla gun, rubber bullet and crystal shards), a Storm Globes and a carefully written note here.

4:24 am

>w
Crowther Lab
The walls of this spherical room are tiled in brass and streaked with soot from Dr Crowther's lightning experiments, but now it is dominated by the Crowther Engine.

You can see a metal door, the Crowther Engine (closed), a Brass Man and a doors panel (on which is a key) here.

4:25 am

>e
Prime Laboratory
This massive barrel-vaulted chamber is clustered with half a dozen ongoing experiments. Sparks surge between twisted prongs, sulphorous liquids bubble and murmur, and a half-made automaton rocks itself back and forth in the corner. The hair on the back of your neck rises. This could be from the terrible portent of the experiments conducted here over the centuries or it could be from the actinic charge in the air. 

 Crowther's Lab is to the west and the Insectarium is to the east. An archway leads south to the flight platform and is also useful for venting in an emergency.

You can see the Cogway, a Rail (on which is a Daedulus Flutter-wing (empty)), the Slow Glass, some Arcane Paraphernalia (in which are a spider-silk rope, perpetual machine, Tesla gun, rubber bullet and crystal shards), a Storm Globes and a carefully written note here.

4:26 am

>e
Clockwork Insectarium
This room is filled with twisted metal and stained glass constructs in a caricature of a jungle environment. Oversized clockwork beetles, worms, butterflies and spiders move slugishly among the syntetic foliage. A stained glass doorway leads west back to the main laboratory.

You can see the clockwork insects here.

4:27 am

>s
You can't go that way.

4:28 am

>n
Dr Crowther's study
This spacy room contains a sofa on the right side and a large bookshelf at the back. In front of you is Dr Crowther's desk.

You can see Dr Crowther's desk here.

4:29 am

>examine desk
A large desk filled withdrawings and scrappy notes. Crowther's life's work right here. You also find some lotion and a roll of tissue paper. Not sure why but better not touch them. The desk contains a set of drawers. They could contain something interesting.

4:30 am

>open drawers
You open Dr Crowther's drawers, revealing an old pump air pistol.

4:31 am

>take
(Dr Crowther's desk)
That's fixed in place.

4:32 am

>take pistol
Taken.

4:33 am

>s
Clockwork Insectarium
This room is filled with twisted metal and stained glass constructs in a caricature of a jungle environment. Oversized clockwork beetles, worms, butterflies and spiders move slugishly among the syntetic foliage. A stained glass doorway leads west back to the main laboratory.

You can see the clockwork insects here.

4:34 am

>w
Prime Laboratory
This massive barrel-vaulted chamber is clustered with half a dozen ongoing experiments. Sparks surge between twisted prongs, sulphorous liquids bubble and murmur, and a half-made automaton rocks itself back and forth in the corner. The hair on the back of your neck rises. This could be from the terrible portent of the experiments conducted here over the centuries or it could be from the actinic charge in the air. 

 Crowther's Lab is to the west and the Insectarium is to the east. An archway leads south to the flight platform and is also useful for venting in an emergency.

You can see the Cogway, a Rail (on which is a Daedulus Flutter-wing (empty)), the Slow Glass, some Arcane Paraphernalia (in which are a spider-silk rope, perpetual machine, Tesla gun, rubber bullet and crystal shards), a Storm Globes and a carefully written note here.

4:35 am

>take bullet
Taken.

4:36 am

>put bullet in pistol
You put rubber bullet into the old pump air pistol.

4:37 am

>shoot pistol
What do you want to shoot the old pump air pistol with?

4:37 am

>shoot pistol with bullet
"Cannot see why I should
4:38 am

* * *

>take bullet
Taken.

4:22 am

>e
Clockwork Insectarium
This room is filled with twisted metal and stained glass constructs in a caricature of a jungle environment. Oversized clockwork beetles, worms, butterflies and spiders move slugishly among the syntetic foliage. A stained glass doorway leads west back to the main laboratory.

You can see the clockwork insects here.

4:23 am

>n
Dr Crowther's study
This spacy room contains a sofa on the right side and a large bookshelf at the back. In front of you is Dr Crowther's desk.

You can see Dr Crowther's desk here.

4:24 am

>open drawers
You open Dr Crowther's drawers, revealing an old pump air pistol.

4:25 am

>take pistol
Taken.

4:26 am

>put bullet in pistol
You put rubber bullet into the old pump air pistol.

4:27 am

>shoot pistol with bullet
"Cannot see why I should.

4:28 am

>w
You can't go that way.

4:29 am

>w
You can't go that way.

4:30 am

>s
Clockwork Insectarium
This room is filled with twisted metal and stained glass constructs in a caricature of a jungle environment. Oversized clockwork beetles, worms, butterflies and spiders move slugishly among the syntetic foliage. A stained glass doorway leads west back to the main laboratory.

You can see the clockwork insects here.

4:31 am

>w
Prime Laboratory
This massive barrel-vaulted chamber is clustered with half a dozen ongoing experiments. Sparks surge between twisted prongs, sulphorous liquids bubble and murmur, and a half-made automaton rocks itself back and forth in the corner. The hair on the back of your neck rises. This could be from the terrible portent of the experiments conducted here over the centuries or it could be from the actinic charge in the air. 

 Crowther's Lab is to the west and the Insectarium is to the east. An archway leads south to the flight platform and is also useful for venting in an emergency.

You can see the Cogway, a Rail (on which is a Daedulus Flutter-wing (empty)), the Slow Glass, some Arcane Paraphernalia (in which are a spider-silk rope, perpetual machine, Tesla gun and crystal shards), a Storm Globes and a carefully written note here.

4:32 am

>w
Crowther Lab
The walls of this spherical room are tiled in brass and streaked with soot from Dr Crowther's lightning experiments, but now it is dominated by the Crowther Engine.

You can see a metal door, the Crowther Engine (closed), a Brass Man and a doors panel (on which is a key) here.

4:33 am

>shoot
What do you want to shoot?

4:33 am

>shoot pistol with bullet
"Tak!" The key falls and you grab it
4:34 am

>inventory
You are carrying:
  a key
  an old pump air pistol
    rubber bullet
  an explanatory note

4:35 am

>e
Prime Laboratory
This massive barrel-vaulted chamber is clustered with half a dozen ongoing experiments. Sparks surge between twisted prongs, sulphorous liquids bubble and murmur, and a half-made automaton rocks itself back and forth in the corner. The hair on the back of your neck rises. This could be from the terrible portent of the experiments conducted here over the centuries or it could be from the actinic charge in the air. 

 Crowther's Lab is to the west and the Insectarium is to the east. An archway leads south to the flight platform and is also useful for venting in an emergency.

You can see the Cogway, a Rail (on which is a Daedulus Flutter-wing (empty)), the Slow Glass, some Arcane Paraphernalia (in which are a spider-silk rope, perpetual machine, Tesla gun and crystal shards), a Storm Globes and a carefully written note here.

4:36 am

>w
Crowther Lab
The walls of this spherical room are tiled in brass and streaked with soot from Dr Crowther's lightning experiments, but now it is dominated by the Crowther Engine.

You can see a metal door, the Crowther Engine (closed), a Brass Man and a doors panel here.

4:37 am

>n
Morgue
 This room has a noticeably lower temperature. The walls have been fitted with drawers presumably contaning corpses waiting to be experimented on by Dr Crowther. A large metal table containing various tools is positioned in the middle of the room.  A large metallic cabinet is at the back of the room, a label on it says "Congelator".

You can see a Congelator (closed) here.

4:38 am

>open congelator
You open the Congelator, revealing an appetizing chocolate cupcake.

4:39 am

>eat cupcake
(first taking the appetizing chocolate cupcake)
"gulp" Nice.

4:40 am

>s
Crowther Lab
The walls of this spherical room are tiled in brass and streaked with soot from Dr Crowther's lightning experiments, but now it is dominated by the Crowther Engine.

You can see a metal door, the Crowther Engine (closed), a Brass Man and a doors panel here.

4:41 am

>e
Prime Laboratory
This massive barrel-vaulted chamber is clustered with half a dozen ongoing experiments. Sparks surge between twisted prongs, sulphorous liquids bubble and murmur, and a half-made automaton rocks itself back and forth in the corner. The hair on the back of your neck rises. This could be from the terrible portent of the experiments conducted here over the centuries or it could be from the actinic charge in the air. 

 Crowther's Lab is to the west and the Insectarium is to the east. An archway leads south to the flight platform and is also useful for venting in an emergency.

You can see the Cogway, a Rail (on which is a Daedulus Flutter-wing (empty)), the Slow Glass, some Arcane Paraphernalia (in which are a spider-silk rope, perpetual machine, Tesla gun and crystal shards), a Storm Globes and a carefully written note here.

4:42 am

>s
Launch Platform
Up there you can feel the fresh breeze which contrasts with the damp acrid smell of the laboratories. In front of you is a large hot air balloon that looks ready for take off.

You can see a Tower Wall here.

4:43 am

>s
You can't go that way.

4:44 am

>n
Prime Laboratory
This massive barrel-vaulted chamber is clustered with half a dozen ongoing experiments. Sparks surge between twisted prongs, sulphorous liquids bubble and murmur, and a half-made automaton rocks itself back and forth in the corner. The hair on the back of your neck rises. This could be from the terrible portent of the experiments conducted here over the centuries or it could be from the actinic charge in the air. 

 Crowther's Lab is to the west and the Insectarium is to the east. An archway leads south to the flight platform and is also useful for venting in an emergency.

You can see the Cogway, a Rail (on which is a Daedulus Flutter-wing (empty)), the Slow Glass, some Arcane Paraphernalia (in which are a spider-silk rope, perpetual machine, Tesla gun and crystal shards), a Storm Globes and a carefully written note here.

4:45 am

>w
Crowther Lab
The walls of this spherical room are tiled in brass and streaked with soot from Dr Crowther's lightning experiments, but now it is dominated by the Crowther Engine.

You can see a metal door, the Crowther Engine (closed), a Brass Man and a doors panel here.

4:46 am

>s
(first opening the metal door)
It seems to be locked.

4:47 am

>open
What do you want to open?

4:47 am

>metal door
It seems to be locked.

4:48 am

>open metal door with key
You unlock the metal door.

4:49 am

>s
(first opening the metal door)

Curmudgeons tactical room
On entering you see a large table surrounded by chairs. A map lays flat on it. To your right is a weapons table.

You can see a metal door, a weapons table (in which is a bomb (on which is a timer)) and a command table (on which is a map) here.

4:50 am

>examine command table
On the command table is a map.

4:51 am

>examine map
A map depicting the nearby town, Mekley with an "X" marked on the town. The picture of a bomb is also drawn on the town. Could those fiendish Curmudgeons be planning to bomb Mekley?! I have to stop this.

4:52 am

>look at weapons talbe
You can't see any such thing.

4:52 am

>look at weapons table
In the weapons table is a bomb.

4:53 am

>examine bomb
A large pipe bomb with a timer attached to it. The bomb looks impressively dangerous.

On the bomb is a timer.

4:54 am

>switch timer on
15 minutes. Gotta get out of here.

4:55 am

>n
Crowther Lab
The walls of this spherical room are tiled in brass and streaked with soot from Dr Crowther's lightning experiments, but now it is dominated by the Crowther Engine.

You can see a metal door, the Crowther Engine (closed), a Brass Man and a doors panel here.

4:56 am

>e
Prime Laboratory
This massive barrel-vaulted chamber is clustered with half a dozen ongoing experiments. Sparks surge between twisted prongs, sulphorous liquids bubble and murmur, and a half-made automaton rocks itself back and forth in the corner. The hair on the back of your neck rises. This could be from the terrible portent of the experiments conducted here over the centuries or it could be from the actinic charge in the air. 

 Crowther's Lab is to the west and the Insectarium is to the east. An archway leads south to the flight platform and is also useful for venting in an emergency.

You can see the Cogway, a Rail (on which is a Daedulus Flutter-wing (empty)), the Slow Glass, some Arcane Paraphernalia (in which are a spider-silk rope, perpetual machine, Tesla gun and crystal shards), a Storm Globes and a carefully written note here.

4:57 am

>s
Launch Platform
Up there you can feel the fresh breeze which contrasts with the damp acrid smell of the laboratories. In front of you is a large hot air balloon that looks ready for take off.

You can see a Tower Wall here.

4:58 am

>up
Balloon Mooring
You can see a Hot-Air Balloon (empty) here.

4:59 am

>get on Hot-ari Balloon
You can't see any such thing.

4:59 am

>get on Hot-air Balloon
You get into the Hot-Air Balloon.

5:00 am

>west
*** The bomb explodes, destroying the Curmudgeons tower and their laboratories while you watch, flying away in the Hot-Air Balloon. You Win. ***

Would you like to RESTART, RESTORE a saved game, QUIT or UNDO the last command?

* * *

>look
Shielded Corridor
Outside the Laboratories of the Worthy Order of Curmudgeons, the walls are shielded with sonic damping, fire proofing, acid-resistant lacquer, structural supports and storm baffling. (The last a recent addition inspired by Dr Crowther's experiments). The imposing entrance to the Prime Laboratory is in the south wall.

You can see the Cogway here.

>examine note
You can't see any such thing.

>note
That's not a verb I recognise.

>look at explanatory note
You can't see any such thing.

>inventory
You are carrying nothing.

>pick up note
You can't see any such thing.

>read note
You can't see any such thing.

>read explanatory note
You can't see any such thing.

* * *

>inventory
You are carrying nothing.

>read note
You can't see any such thing.

* * *

>read explanatory note
You can't see any such thing.

>examine explanatory note
You can't see any such thing.

* * *

>inventory
You are carrying nothing.

>examine note
You can't see any such thing.

>read explanatory note
You can't see any such thing.

* * *

>pick up note
You can't see any such thing.

>pick up explanatory note
You can't see any such thing.

* * *

>read note
This hastily penned note reads "I'm sure she is somewhere in the laboratories".

>examine note
You can't see any such thing.

* * *

>note
That's not a verb I recognise.

>pick up explanatory note
You can't see any such thing.

* * *

>read note
This hastily penned note reads "I'm sure she is somewhere in the laboratories".

>n
You can't go that way.

>s
(first opening the Cogway)
It seems to be locked.

>w
You can't go that way.

>e
You can't go that way.

>s
(first opening the Cogway)
It seems to be locked.

>unlock cogway
(with the explanatory note)
That doesn't seem to fit the lock.